"ensemble" "accuNCV" "last"
"1-2" NA NA
"1-2" 0.623175510204082 1
"1-2-3" 0.66554693877551 1
"1-2-3-4" 0.671281632653061 1
"1-2-3-4-5" 0.671285714285714 1
"1-2-3-4-5-6" 0.676734693877551 1
