"ensemble" "accuNCV" "last"
"1-2" NA NA
"1-2" 0.667832653061225 1
"1-2-3" 0.665779591836735 0
"1-2-4" 0.666 0
"1-2-5" 0.673012244897959 1
"1-2-5-6" 0.679612244897959 1
"1-2-5-6-7" 0.679391836734694 0
"1-2-5-6-8" 0.680428571428571 1
"1-2-5-6-8-9" 0.681432653061224 1
