"ensemble" "accuNCV" "last"
"1-2" NA NA
"1-2" 0.608955102040816 1
"1-2-3" 0.635334693877551 1
"1-2-3-4" 0.643697959183673 1
"1-2-3-4-5" 0.654085714285714 1
"1-2-3-4-5-6" 0.656955102040816 1
