"ensemble" "accuNCV" "last"
"1-2" NA NA
"1-2" 0.765096618357488 1
"1-2-3" 0.767521739130435 1
"1-2-3-4" 0.76443961352657 0
"1-2-3-5" 0.767753623188406 1
"1-2-3-5-6" 0.769323671497585 1
"1-2-3-5-6-7" 0.771314009661836 1
"1-2-3-5-6-7-8" 0.76956038647343 0
"1-2-3-5-6-7-9" 0.769323671497585 0
