"ensemble" "accuNCV" "last"
"1-2" NA NA
"1-2" 0.603032653061224 1
"1-2-3" 0.633959183673469 1
"1-2-3-4" 0.642669387755102 1
"1-2-3-4-5" 0.646959183673469 1
"1-2-3-4-5-6" 0.650979591836735 1
"1-2-3-4-5-6-7" 0.654424489795918 1
"1-2-3-4-5-6-7-8" 0.660938775510204 1
"1-2-3-4-5-6-7-8-9" 0.656289795918367 0
"1-2-3-4-5-6-7-8-10" 0.659755102040816 0
"1-2-3-4-5-6-7-8-11" 0.663575510204082 1
